S#######_______
_______#_______
S###########___
_______#___#___
_______E####___